{
    "tilemap": [
        "3333333333",
        "3        3",
        "3 p      3",
        "3        3",
        "3        3",
        "3        3",
        "3     *  3",
        "3        3",
        "3        3",
        "3333333333"
    ]
}
