[
    "3333333333",
    "3 3 * 3  3",
    "3 3   3  3",
    "3 33d33  3",
    "3        3",
    "3   p    3",
    "3        3",
    "3      k 3",
    "3        3",
    "3333333333"
]
