[
    "3333333333",
    "3        3",
    "3        3",
    "3        3",
    "3p   e * 3",
    "3        3",
    "3        3",
    "3        3",
    "3        3",
    "3333333333"
]
