[
    "3333333333",
    "3    3   3",
    "3    3 * 3",
    "3    3   3",
    "3p   3   3",
    "3    3 e 3",
    "3    3   3",
    "3        3",
    "3        3",
    "3333333333"
]
