[
    "3333333333",
    "3p  sss* 3",
    "3  3sss  3",
    "3  3 e  w3",
    "3     wk 3",
    "3wwwvww333",
    "3wwwvwwww3",
    "3* t hhd*3",
    "3  t ww  3",
    "3333333333"
]
