{
    "theme": "c",
    "tilemap": [
        "33333333333333333333",
        "30000030000000300003",
        "30000000000000000003",
        "30000000000000000003",
        "30000000000000000003",
        "30000000000000000003",
        "30000000000000000003",
        "30000000000000000003",
        "30000000000000000003",
        "30000000000000000003",
        "30000200000000000003",
        "30000200000000000003",
        "30000200000000000003",
        "30000200000000000003",
        "30000000000000000003",
        "30000000000000000003",
        "30000000000000000003",
        "30000000000000000003",
        "30000000000000000003",
        "33333333333333333333"
    ],
    "objects": [
        "                    ",
        "                    ",
        "                    ",
        "                    ",
        "                    ",
        "                    ",
        "               k    ",
        "                    ",
        "                    ",
        "                    ",
        "                    ",
        "                    ",
        "0000010*000000000000",
        "                    ",
        "                    ",
        "                    ",
        "                    ",
        "                    ",
        "                    ",
        "                    "
    ],
    "agents": {
        "player": {
            "position": [3.0, 3.0]
        }
    }
}
