{
    "theme": "b",
    "tilemap": [
        "000200000000000000000000",
        "000200000000000000000000",
        "000200000020000000000022",
        "000200000000000000000000",
        "000200000000000000000000",
        "000200000000000000000000",
        "000200000000000000000000",
        "000222222220000000000000",
        "000000000020000000000000",
        "000000000020000000000000",
        "000000000020000000000000",
        "000000000020000000000000",
        "000000000020000000000000",
        "000000000020000000000000",
        "000000000020000000000000",
        "000000000020000000000000",
        "000000000020000000000000",
        "000000000020000000000000",
        "000000000020000000000000",
        "000000000020000000000000",
        "000000000020000000000000",
        "000000000020000000000000",
        "000000000020000000000000",
        "000000000020000000000002"
    ],
    "objects": [
        "000000000000000000000000",
        "000000000000000000000000",
        "000000000000000000000000",
        "000100000000000000000000",
        "000000000000000000000000",
        "000000000000000000000000",
        "000000000000000000000000",
        "000000020000000000000000",
        "000000000000000000000000",
        "000000000000000000000000",
        "000000000000000000000000",
        "000000000000000000000000",
        "000000000000000000000000",
        "000000000000000000000000",
        "000000000000000000000000",
        "000000000000000000000000",
        "000000000000000000000000",
        "000000000000000000000000",
        "000000000000000000000000",
        "000000000000000000000000",
        "000000000000000000000000",
        "000000000000000000000000",
        "000000000000000000000000",
        "000000000000000000000000"
    ],
    "agents": {
        "player": {
            "position": [10.0, 1.0]
        }
    }
}
